aaron	aaron
ab	ab
abbas	abbas
abbott	abbott
abc	abc
abs	abs
access	access
account	account
ace	ace
acer	Acer
acid	Acid
acoustic	Acoustic
action	action
active	active
ad	Ad
adam	Adam
adams	adams
adapter	adapter
add	add
ad	ad
adele	adele
adidas	adidas
admin	Admin
adobe	Adobe
advanced	advanced
afghanistan	Afghnistan
agribank	Agribank
aguero	aguero
ah	ah
aids	AIDS
air	air
airlines	airlines
ajax	Ajax
al	al
alan	alan
alaska	Alaska
alba	alba
albert	Albert
album	album
alex	Alex
alexander	Alexander
alexandra	Alexandra
alexis	Alexis
alfred	Alfred
algeria	Algeria
ali	Ali
alice	Alice
all	all
allen	allen
all	all
alonso	Alonso
alpha	Alpha
alt	alt
alves	Alves
alzheimer	Alzheimer
amazon	Amazon
amd	AMD
america	America
american	American
america	America
amin	Amin
amp	AMP
ampli	ampli
amsterdam	Amsterdam
amy	amy
and	and
anderson	Anderson
andrea	Andrea
andrew	Andrew
android	Android
andy	Andi
angela	Angela
angel	angel
angeles	Angeles
angel	angel
angelina	angelina
ann	Ann
anna	Anna
anne	anne
annie	annie
anthony	Anthony
anti	anti
antonio	Antonio
apec	APEC
app	App
apple	Apple
apply	apply
apps	Apps
aquino	Aquino
arab	Arab
arabia	Arabia
arafat	arafat
arc	arc
arena	Arena
argentina	Argentina
arizona	Arizona
arsenal	Arsenal
art	art
arthur	Arthur
as	as
asean	ASEAN
ashley	Ashley
ashton	ashton
asia	ASIA
asian	ASIAN
asia	ASIA
aspirin	Aspirin
assad	assad
aston	aston
asus	Asus
athens	Athens
atlanta	Atlanta
atm	ATM
audi	Audi
audio	audio
australia	Australia
auto	auto
avatar	Avatar
awards	awards
axit	Axit
baby	baby
back	back
background	background
backup	backup
bad	bad
baggio	baggio
baghdad	Baghdad
baking	baking
bale	Bale
bali	Bali
ballad	ballad
ballet	ballet
baltic	Baltic
band	band
bangkok	Bangkok
bangladesh	Bangladesh
bank	bank
banking	banking
banner	banner
barack	Barack
bar	bar
barca	Barca
barcelona	Barcelona
basa	Basa
bass	bass
bbc	BBC
beach	beach
bean	bean
beat	beat
beats	beats
beauty	beauty
beckham	Beckham
becks	becks
belarus	Belarus
bella	Bella
benitez	Benitez
benjamin	Benjamin
bentley	bentley
berlin	Berlin
berlusconi	berlusconi
berry	berry
best	best
beta	beta
beyonce	beyonce
bg	bg
biden	biden
bieber	bieber
big	big
bikini	bikini
bill	bill
billy	billy
bios	bios
birmingham	Birmingham
bis	bis
blackberry	Blackberry
black	black
blackburn	Blackburn
blade	Blade
blair	blair
blake	blake
blanc	blanc
blazer	blazer
block	block
blog	blog
blogger	blogger
blog	blog
blood	blood
bloomberg	Bloomberg
blue	blue
blues	blues
bluetooth	bluetooth
bmw	BMW
bob	Bob
bobby	bobby
body	body
boeing	Boeing
bold	bold
bolton	Bolton
bond	bond
book	book
boots	boots
boss	boss
boston	Boston
botox	botox
boy	boy
bphone	Bphone
brad	brad
brazil	Brazil
break	break
brendan	brendan
brian	Brian
bridge	bridge
britney	Britney
bro	bro
brom	Brom
brooklyn	Brooklyn
brown	brown
browser	browser
bruce	Bruce
brunei	Brunei
bruno	Bruno
brussels	Brussels
bryan	bryan
bt	bt
btc	btc
buffet	buffet
buffett	buffett
bugi	bugi
build	build
bulgaria	Bulgaria
bull	bull
bus	bus
bush	bush
business	business
button	button
bye	bye
cabin	cabin
cable	cable
cache	cache
caesar	Caesar
cafe	cafe
café	café
cafe	cafe
café	café
caffeine	caffeine
california	California
cali	cali
call	call
calo	calo
cambridge	Cambridge
camera	camera
cameron	cameron
cameroon	Cameroon
campbell	Campbell
campuchia	Campuchia
camry	Camry
canada	Canada
candy	candy
cannes	cannes
canon	Canon
canxi	canxi
capello	capello
capital	capital
carbohydrate	Carbohydrate
carbon	Carbon
cardiff	Cardiff
card	card
care	care
carey	carey
carl	carl
carlo	Carlo
carlos	Carlos
caro	caro
carolina	carolina
caroline	caroline
carol	Carol
carrick	Carick
carrie	carrie
carter	carter
case	case
casillas	Casillas
casino	casino
cassette	cassette
casting	casting
castro	castro
catalan	Catalan
catherine	catherine
catwalk	catwalk
cave	cave
cc	cc
cd	cd
cell	cell
center	center
champagne	champagne
champions	champions
chanel	chanel
change	change
charles	charles
charlie	Charlie
charlotte	Charlotte
chavez	Chavez
chechnya	chechnya
check	check
chelsea	Chelsea
cherry	cherry
cheryl	cheryl
chevrolet	Chevrolet
chicago	Chicago
chile	Chile
china	China
chocolate	chocolate
cholesterol	Cholesterol
chris	Chris
christian	Christian
christina	Christina
christine	Christine
christopher	Christopher
chrome	Chrome
chuck	chuck
cindy	cindy
cisco	Cisco
city	city
civic	civic
clara	clara
clark	clark
classic	classic
class	class
clear	clear
click	click
client	client
clinton	Clinton
clip	clip
close	close
cloud	cloud
club	club
cm	cm
cn	cn
coca	coca
cocktail	cocktail
code	code
coffee	coffee
cola	cola
coleen	coleen
cole	cole
colin	colin
collagen	collagen
college	college
collins	collins
colombia	Colombia
colorado	colorado
color	color
columbia	Columbia
combo	combo
comment	comment
compact	compact
computer	computer
concept	concept
concert	concert
confirm	confirm
connect	connect
console	console
contact	contact
container	container
conte	conte
content	content
control	control
convert	convert
cookie	cookie
cook	cook
cool	cool
cooper	cooper
copy	copy
core	core
corp	corp
corticoid	corticoid
cortisol	Cortisol
costa	Costa
cotton	cotton
cover	cover
cp	cp
craig	craig
cream	cream
credit	credit
crimea	crimea
cristiano	Cristiano
croatia	Croatia
crop	crop
crouch	crouch
cruise	cruise
cruze	cruze
cruz	Cruz
crystal	crystal
ctrl	ctrl
cuba	Cuba
custom	custom
cyrus	cyrus
czech	Czech
daily	daily
dallas	dallas
dana	dana
dance	dance
daniel	Daniel
danny	danny
darcy	darcy
dark	dark
data	data
date	date
david	David
davis	Davis
dc	dc
dean	dean
del	del
delete	delete
delhi	delhi
dell	dell
demi	demi
demo	demo
denim	denim
depp	depp
derby	derby
der	der
design	design
desire	desire
desktop	desktop
device	device
đh	đh
diamond	diamond
diana	Diana
diane	diane
dicaprio	dicaprio
die	die
diego	Diego
diesel	diesel
digital	digital
dior	dior
dioxin	dioxin
discovery	discovery
disk	disk
disney	Disney
diva	Diva
dj	dj
dl	dl
dna	dna
dock	dock
đôla	đôla
domain	domain
donald	Donald
doping	doping
dortmund	Dortmund
douglas	Douglas
dow	dow
down	down
download	download
dragon	dragon
dream	dream
drive	drive
driver	driver
dslr	dslr
dubai	Dubai
dumbledore	dumbledore
	0
dustin	Dustin
dvd	dvd
dylan	dylan
earth	earth
easy	easy
ebay	Ebay
ebola	Ebola
eco	Eco
ecuador	Ecuador
ed	ed
eden	Eden
edge	edge
ed	ed
edit	edit
edward	Edward
eiffel	Eiffel
einstein	Einstein
el	el
electrolux	Electrolux
electron	electron
elite	Elite
elizabeth	Elizabeth
ellen	ellen
elly	elly
elvis	elvis
email	email
emily	Emily
emirates	Emirates
emma	Emma
end	end
english	English
enrique	Enrique
enter	enter
entertainment	entertainment
enzyme	enzyme
eric	Eric
ericsson	Ericsson
estrogen	Etrogen
eu	EU
euro	Euro
europa	Europa
eva	Eva
evans	Evans
event	event
everest	Everest
everton	Everton
excel	Excel
exchange	exchange
explorer	explorer
express	Express
fabio	Fabio
facebook	Facebook
face	Facebook
factor	factor
factory	factory
fair	fair
fake	fake
fans	fans
fashion	fashion
fast	fast
fbi	FBI
federer	Federer
fed	fed
ferdinand	Ferdinand
ferguson	Ferguson
fernando	Fernando
ferrari	Ferrari
festival	festival
fifa	FIFA
file	file
files	files
film	film
financial	financial
fire	fire
firewall	firewall
first	first
fitch	fitch
flash	flash
flc	flc
fletcher	Fletcher
florida	Florida
fm	fm
focus	focus
folder	folder
folic	folic
font	font
food	food
forbes	Forbes
ford	Ford
format	format
form	form
for	for
forum	forum
foundation	foundation
fpt	FPT
france	France
francisco	Francisco
francis	Francis
frank	Frank
fred	Fred
free	free
from	from
fukushima	Fukushima
full	full
futsal	futsal
gaal	gaal
gadhafi	Gadhafi
gaga	gaga
gala	gala
galaxy	Galaxy
gallery	gallery
game	game
gameplay	gameplay
gamer	gamer
games	games
gameshow	gameshow
garage	garage
garcia	Garcia
garden	garden
gareth	Gareth
gary	Gary
gas	gas
gates	gates
gaza	Gaza
gear	gear
gel	gel
gene	gene
general	general
geneva	Geneva
george	George
georgia	Georgia
ghana	Ghana
ghost	ghost
gil	gil
gio	gio
girl	girl
girls	girls
glass	glass
glazer	glazer
global	global
glucose	glucose
gmail	gmail
goetz	goetz
golden	golden
gold	gold
goldman	goldman
golf	golf
gomez	Gomez
good	good
google	Google
gordon	Gordon
gout	gout
gps	GPS
grace	grace
grand	grand
grant	grant
great	great
green	green
greg	greg
group	group
gsm	GSM
gt	gt
guardian	Guardian
guardiola	guardiola
gucci	Gucci
guiliano	Guiliano
guinness	Guinness
guitar	Guitar
gulliver	Gulliver
hacker	hacker
hack	hack
hagel	hagel
haiti	Haiti
halloween	Halloween
hamas	hamas
hamilton	Hamilton
hand	hand
handmade	handmade
hannibal	Hannibal
hanoi	Hanoi
happy	happy
hard	hard
hari	hari
harper	harper
harris	Harris
harry	Harry
hart	hart
harvard	Harvard
hawaii	Hawaii
hazard	Hazard
hdd	hdd
hd	HD
head	head
headphone	headphone
hee	hee
helen	Helen
hello	hello
help	help
henry	Henry
hermione	Hermione
hero	hero
heroin	heroin
high	high
hillary	Hillary
hill	hill
hills	hills
hilton	Hilton
hitler	Hitler
hodgson	Hodgson
hok	hok
holly	holly
hollywood	Hollywood
holmes	Holmes
home	home
honda	Honda
honduras	Honduras
honey	honey
hongkong	HongKong
hormone	hormone
hose	hose
host	host
hotel	hotel
house	house
houston	houston
howard	Howard
hp	HP
hsbc	HSBC
htc	HTC
hub	hub
hughes	hughes
hugh	hugh
hugo	Hugo
hull	hull
hungary	Hungary
hunter	hunter
hussein	Hussein
hybrid	hybrid
hydro	hydro
hye	hye
hyundai	Hyundai
hyun	hyun
ibm	IBM
iceland	Iceland
icon	icon
id	id
idol	idol
image	image
implant	implant
inc	inc
index	index
india	India
indochina	Indochina
indonesia	Indonesia
instagram	Instagram
install	install
insulin	insulin
intel	Intel
inter	inter
international	international
internet	internet
interpol	Interpol
ion	ion
ios	IOS
ipad	Ipad
iphone	Iphone
ipod	Ipod
iran	Iran
iraq	Iraq
	0
is	IS
island	Island
iso	ISO
israel	Israel
italia	Italia
italy	Italy
item	item
itunes	Itunes
iv	iv
jack	jack
jacket	jacket
jackson	Jackson
jacob	Jacob
jae	jae
jakarta	Jakarta
jake	Jake
james	James
jamie	Jamie
jane	Jane
janet	Janet
jang	jang
janna	janna
japan	Japan
jason	Jason
java	Java
jay	jay
jazz	jazz
jean	jean
jeans	jeans
jeep	jeep
jeff	jeff
jen	jen
jennifer	Jennifer
jenny	Jenny
jerry	jerry
jerusalem	Jerusalem
jessica	Jessica
jessie	jessie
jesus	Jesus
jica	Jica
ji	ji
jim	Jim
jimmy	Jimmy
jin	jin
job	job
jobs	jobs
joe	Joe
johansson	Johansson
john	John
johnny	Johnny
johnson	Johnson
jolie	Jolie
jonathan	Jonathan
jones	Jones
jong	jong
joo	joo
joon	joon
joong	joong
jordan	Jordan
jose	Jose
joseph	Joseph
journal	journal
juan	juan
julia	Julia
juliet	Juliet
jumpsuit	jumpsuit
jun	jun
jung	jung
junior	junior
justin	Justin
juve	Juve
juventus	Juventus
karaoke	karaoke
kardashian	kardashian
karl	karl
kate	kate
kathy	kathy
katie	katie
katy	katy
kazakhstan	kazakhstan
keane	keane
kelly	kelly
kennedy	Kenedy
kenny	Kenny
kenya	Kenya
kernel	kernel
kern	kern
kerr	kerr
kerry	kerry
kevin	Kevin
keyboard	keyboard
key	key
kg	kg
kh	kh
khmer	Khmer
	0
kidman	kidman
kids	kids
kiev	Kiev
kindle	Kindle
kissinger	kissinger
kiss	kiss
kitty	Kitty
kiwi	kiwi
klopp	Klopp
km	km
knock	knock
korea	Korea
kpop	Kpop
kremlin	Kremlin
kris	Kris
kristen	kristen
kuala	kuala
kuwait	Kuwait
laden	laden
lady	lady
lag	lag
lamborghini	Lamborghini
land	land
lane	lane
langdon	langdon
lanka	lanka
laptop	laptop
lara	lara
larry	larry
laser	laser
las	las
latinh	latinh
latin	latin
laura	Laura
lauren	Lauren
laurent	Laurent
lavender	Lavender
lawrence	lawrence
layer	layer
lcd	LCD
league	league
led	led
leeds	leeds
lee	Lee
lego	lego
leicester	Leicerter
lenovo	Lenovo
lens	lens
leonardo	Leonardo
les	les
level	level
lewis	Lewis 
lexicon	lexicon
lexus	Lexus
lg	lg
lhp	lhp
liberty	Liberty
libya	Libya
life	life
light	light
like	like
lily	lily
lincoln	Lincoln
linda	Linda
lindsay	lindsay
line	line
link	link
linux	Linux
lionel	Lionel
lipid	lipid
lisa	lisa
list	list
little	little
live	live
liverpool	Liverpool
liveshow	liveshow
liz	liz
load	load
lock	lock
logic	logic
logistics	logistics
log	log
logo	logo
lol	lol
london	London
lopez	Lopez
lotte	Lotte
louis	Louis
love	love
low	low
lucas	Lucas
lucy	Lucy
luis	Luis
luiz	Luiz
luke	luke
lumia	lumia
lumpur	Lumpur
lx	LX
lyon	Lyon
macau	Macau
macbook	Macbook
macro	macro
made	made
madonna	madonna
madrid	Madrid
mafia	mafia
magic	magic
magie	magie
mail	mail
make	make
makeup	makeup
malaysia	Malaysia
malware	malware
mama	mama
management	management
manager	manager
manchester	Manchester
mancini	Mancini
manhattan	Manhattan
manila	Manila
manuel	Manuel
maps	maps
maradona	Maradona
marathon	marathon
marc	marc
margaret	margeret
margin	margin
maria	Maria
mariah	mariah
maria	Maria
marie	Marie
marilyn	marilyn
mario	Mario
maritime	Maritime
marketing	marketing
market	market
mark	mark
marseille	Marseille
martinez	Martinez
martin	Martinez
martino	martino
mart	mart
mary	mary
mascara	Mascara
massachusetts	Massachusett
massage	massage
master	master
masters	masters
mata	mata
matthew	Matthew
matt	matt
maxi	maxi
maya	Maya
mazda	mazda
mba	MBA
mccain	mccain
mcdonald	McDonald
mc	MC
mclaren	McLaren
media	media
medvedev	Medvedev
megan	megan
mekong	Mekong
melanin	melanin
melbourne	Melbourne
mel	mel
memory	memory
menu	menu
mercedes	Mercedes
merkel	merkel
mer	mer
message	message
messenger	messenger
messi	messi
metro	metro
mexico	Mexico
miami	Miami
michael	Michael
michelle	Michelle
michigan	Michigan
micro	micro
microsoft	Microsoft
mike	Mike
milan	Milan
miley	miley
miller	miller
mini	mini
miranda	Miranda
mirror	mirror
miss	miss
mitsubishi	Mitsubishi
mobifone	Mobifone
mobile	Mobile
model	model
modem	modem
mode	mode
mod	mod
module	module
monaco	Monaco
monroe	monroe
moody	moody
moore	Moore
more	more
morgan	Morgan
morning	morning
moscow	Moscow
moss	moss
môtô	môtô
motor	motor
motorola	Motorola
motors	motors
mourinho	Mourinho
mouse	mouse
moyes	moyes
mr	Mr
mt	mt
mtv	MTV
mubarak	Mubarak
murray	Murray
music	music
myanmar	Myanmar
nadal	Nadal
nail	nail
name	name
nancy	Nancy
nano	nano
naomi	naomi
napoleon	Napoleon
napoli	Napoli
nasa	NASA
natalie	natalie
nathan	Nathan
national	national
nato	NATO
natri	natri
navibank	navibank
neil	neil
nelson	Nelson
nepal	Nepal
network	network
neville	Neville
newcastle	Newcastle
new	new
news	news
newton	Newton
next	next
nexus	Nexus
neymar	Neymar
nguyen	Nguyen
nickname	nickname
nick	nick
nicole	Nicole
nigeria	Nigeria
night	night
nike	Nike
nikon	Nikon
nina	nina
nino	nino
nintendo	nintendo
nixon	nixon
nobel	Nobel
noel	Noel
nokia	Nokia
north	north
norwich	Norwich
note	note
now	now
nude	nude
number	number
nylon	nylon
obama	Obama
ocean	ocean
oda	ODA
office	office
offline	offline
off	off
of	of
oh	oh
ok	ok
okie	okie
ok	ok
old	old
oled	oled
olive	olive
oliver	oliver
olympic	olympic
one	one
online	online
opec	opec
open	open
opera	opera
oppo	Oppo
optimus	optimus
option	option
options	options
oracle	Oracle
order	order
orlando	Orlando
or	or
oscar	Oscar
os	OS
otc	otc
ôtô	ôtô
out	out
outlook	Outlook
owen	Owen
oxford	Oxford
oxy	oxy
pacific	Pacific
pad	pad
page	page
pakistan	Pakistan
palace	palace
palestine	Palestine
palm	palm
panama	Panama
panasonic	Panasonic
panel	panel
paparazzi	paparazzi
paraguay	Paraguay
paris	Paris
parker	parker
parkinson	Parkinson
park	Park
party	party
pass	pass
passport	passport
password	password
pastel	pastel
paste	paste
pasteur	Pasteur
patrick	Patrick
paul	Paul
pc	pc
pdf	pdf
pearl	pearl
pedro	Pedro
pele	Pele
pellegrini	Pellegrini
penalty	penalty
people	people
pepe	Pepe
pepsi	Pepsi
perez	Perez
perry	perry
peru	Peru
peter	Peter
petrolimex	Petrolimex
petro	Petro
philip	Philip
philippines	Philipines
philips	Philips
phillip	Phillip
phil	phil
phnom	phnom
phoenix	phoenix
phone	phone
photocopy	photocopy
photo	photo
photoshop	photoshop
piano	piano
picnic	picnic
pico	Pico
pierre	Pierre
pink	pink
pique	Pique
pitt	pitt
pizza	pizza
plasma	plasma
playbook	playbook
playboy	playboy
player	player
play	play
plaza	plaza
pleiku	Pleiku
plus	plus
pm	pm
pogba	Pogba
point	point
policy	policy
polymer	polymer
polyp	polyp
porsche	Porsche
porto	Porto
port	port
pose	pose
poster	poster
post	post
potter	potter
powell	Powell
power	power
powerpoint	powerpoint
premier	premier
profile	profile
project	project
properties	properties
pro	pro
protein	protein
prudential	Prudential
public	public
pull	pull
push	push
putin	Putin
pvc	PVC
qatar	qatar
queen	queen
quick	quick
quota	quota
quote	quote
rachel	Rachel
radar	radar
radio	radio
rafael	Rafael
ramos	Ramos
ramsey	Ramsey
range	range
ranger	ranger
ranieri	ranieri
rapper	rapper
raul	Raul
raymond	raymond
reader	reader
real	real
reboot	reboot
recovery	recovery
red	red
ree	ree
registry	registry
remote	remote
remove	remove
reply	reply
report	report
reset	reset
resort	resort
restart	restart
restore	restore
reuters	Reuters
review	review
rhett	rhett
rica	rica
rice	rice
richard	Richard
rick	rick
riedl	riedl
rihanna	rihanna
rio	rio
river	river
road	road
robben	robben
roberto	Roberto
robert	Robert
roberts	Roberts
robin	Robin
robot	robot
rock	rock
rodgers	Rodgers
rodriguez	Rodriguez
roger	Roger
rogers	Rogers
roland	Roland
romania	romania
roma	Roma
romeo	Romeo
rome	Rome
ronaldo	Ronaldo
rooney	Rooney
rose	rose
rosie	rosie
rossi	Rossi
ross	ross
router	Router
rover	rover
royal	royal
roy	roy
rubella	Rubella
ruby	ruby
russell	Russell
ruth	ruth
ryan	Ryan
sachs	sachs
sacombank	Sacombank
saddam	saddam
safari	Safari
safe	safe
saigon	Saigon
saint	saint
salad	salad
sales	sales
sale	sale
sally	sally
salon	salon
samba	Samba
samson	Samson
samsung	Samsung
samuel	Samuel
sanchez	Sanchez
sandal	sandal
sandra	Sandra
sandwich	Sandwich
santa	Santa
santos	Santos
sapa	Sapa
sapphire	sapphire
sarah	Sarah
sara	Sara
sars	sars
sar	sar
saudi	Saudi
save	save
scandal	scandal
scan	scan
scarlett	Scarlett
scholes	Scholes
school	school
schumacher	schumacher
scotland	Scotland
scott	Scott
screen	screen
seal	seal
sean	sean
search	search
seattle	seattle
sea	sea
secret	secret
security	security
sedan	sedan
selena	Selena
selfie	selfie
send	send
senkaku	Senkaku
sense	sense
seoul	Seoul
serbia	Serbia
serena	Serena
sergio	Sergio
series	Series
serum	serum
server	server
services	services
service	service
settings	settings
setting	setting
setup	setup
sevilla	sevilla
sexy	sexy
shakira	Shakira
share	share
sharon	sharon
sharp	sharp
shaw	shaw
sh	SH
shell	shell
shift	shift
ship	ship
shock	shock
shoot	shoot
shopping	shopping
shop	shop
shortcut	shortcut
short	short
showbiz	showbiz
showroom	showroom
show	show
sh	SH
sign	sign
silicon	Silicon
silva	Silva
simeone	Simeone
simon	Simon
singapore	Singapore
single	single
siri	Siri
siro	Siro
sir	Sir
site	Site
size	size
skill	skill
skinny	skinny
skin	skin
skype	Skype
sky	Sky
slam	slam
sleep	sleep
slide	slide
slim	slim
slna	Sông Lam Nghệ An
slogan	slogan
slovakia	Slovakia
smartphone	smartphone
smart	smart
smith	Smith
sms	SMS
snowden	snowden
social	social
soda	soda
sofa	sofa
software	software
soft	soft
solo	solo
sol	sol
somalia	Somalia
sony	Sony
sophie	sophie
sorry	sorry
sound	sound
source	source
southampton	Southampton
southern	southern
south	south
space	space
spam	spam
spa	Spa
spears	spears
speed	speed
spencer	spencer
spice	spice
sport	sport
sports	sports
sport	sport
spurs	Spurs
spyware	spyware
sri	Sri
ssd	ssd
ss	ss
ssi	ssi
stalin	Stalin
stamford	Stamford
standard	standard
stanford	Stanford
stanley	Stanley
starbucks	Starbucks
star	star
startup	startup
start	start
star	star
state	state
status	status
st	St
stephen	Stephen
steven	Steven
steve	Steve
stewart	Stewart
stock	stock
stoke	stoke
stone	stone
stop	stop
store	store
storm	storm
stream	stream
street	street
stress	stress
stuart	stuart
studio	studio
style	style
stylist	stylist
suarez	Suarez
sub	sub
sudan	Sudan
sunday	Sunday
sunderland	Sunderland
super	super
support	support
surface	surface
susan	Susan
suv	SUV
suzuki	Suzuki
swift	Swift
sydney	Sydney
symantec	symantec
sync	sync
syria	Syria
system	system
tablet	tablet
tab	tab
taekwondo	Taekwondo
tae	tae
tag	tag
taliban	Taliban
talk	talk
tango	tango
tara	tara
tarzan	tarzan
task	task
tata	tata
taxi	taxi
taylor	Taylor
tb	tb
team	team
teaser	teaser
techcombank	Techcombank
ted	TED
teen	teen
tehran	Tehran
telecom	Telecom
telegraph	telegraph
tel	Tel
tennis	tennis
terry	Terry
testosterone	Testosterone
test	test
texas	Texas
text	text
thanks	thanks
thank	thank
thcs	THCS
theme	theme
thinkpad	Thinkpad
this	this
thomas	Thomas
thompson	Thompson
thread	thread
tiger	Tiger
timeline	timeline
times	times
time	time
timothy	Timothy
tina	Tina
titanic	Titanic
titan	Titan
title	title
tivi	Tivi
toby	toby
today	today
toilet	toilet
tokyo	Tokyo
tommy	Tommy
tone	tone
tony	Tony
tools	tools
tool	tool
topic	topic
toronto	toronto
torres	Torres
toshiba	Toshiba
tottenham	Tottenham
touch	touch
tour	tour
tower	tower
town	town
toyota	Toyota
toy	toy
tp	TP
tracy	Tracy
trafford	Trafford
trailer	trailer
trend	trend
trojan	trojan
troll	troll
	0
trump	Trump
tulip	tulip
tunisia	Tunisia
tv	TV
twitter	Twitter
tyler	tyler
type	type
uber	Uber
ubnd	UBND
ubuntu	ubuntu
uefa	UEFA
uh	uh
uk	UK
ukraine	Ukraine
uk	UK
ultra	ultra
unesco	UNESCO
united	United
universe	Universe
university	University
unlock	unlock
update	update
upload	upload
uranium	Uranium
uric	Uric
uruguay	Uruguay
usa	USA
usb	USB
usd	usd
user	user
us	US
uss	uss
utd	utd
uv	UV
vaccine	vaccine
valdes	Valdes
valencia	Valencia
valentine	Valentine
vanessa	vanessa
vatican	Vatican
vedette	vedette
vegas	Vegas
venezuela	Venezuela
venice	venice
venus	Venus
verizon	verizon
version	version
vertu	Vertu
vespa	Vespa
vest	vest
vff	VFF
vga	VGA
viagra	viagra
victoria	Victoria
victor	Victor
video	video
vietjet	Vietjet
vietnam	VietNam
viettel	Viettel
viet	viet
view	view
viglacera	Viglacera
villarreal	Villarreal
villa	villa
vinamilk	Vinamilk
vinaphone	Vinaphone
vina	Vina
vingroup	Vingroup
vintage	vintage
virginia	Virginia
virus	Virus
visa	visa
vision	Vision
vista	Vista
vitamin	vitamin
vladimir	Vladimir
vnd	VND
vnexpress	VnExpress
vnpt	VNPT
vn	VN
vogue	vogue
voice	voice
volkswagen	Volkswagen
volume	volume
vote	vote
voucher	voucher
vpbank	Vpbank
vp	VP
vs	VS
vtv	VTV
walcott	Walcott
wales	Wales
walker	Walker
wall	wall
wang	Wang
wan	wan
war	war
warren	Warren
war	war
washington	Washington
watch	watch
watson	Watson
wave	wave
wax	wax
way	way
wayne	wayne
way	way
wc	WC
website	website
web	web
week	week
we	we
welbeck	Welbeck
wembley	Wembley
wendy	wendy
wenger	Wenger
western	Western
west	west
white	white
whitney	Whitney
who	WHO
widget	Widget
wifi	Wifi
wikipedia	Wikipedia
will	will
william	William
williams	Williams
william	William
will	will
wilson	Wilson
wimbledon	Wimbledon
window	Window
windows	Windows
win	win
winner	winner
win	win
wipe	wipe
wireless	wireless
with	with
won	won
woods	woods
woo	woo
word	word
world	world
wow	wow
xenon	Xenon
xinhua	Xinhua
yahoo	Yahoo
yamaha	Yamaha
yang	Yang
yemen	Yemen
yen	Yen
yes	yes
yoga	yoga
yong	Yong
yonhap	Yonhap
yoo	Yoo
yoon	yoon
york	York
you	you
young	young
your	your
youtube	Youtube
yu	yu
zealand	Zealand
zero	zero
zhang	Zhang
zidane	Zidane
zika	Zika
zing	Zing
zip	zip
zombie	zombie
zoom	zoom
zuckerberg	Zuckerberg

